关联表								
string	string	int	string	string	string	string	string	string
错误码	客户端(描述)	提示类型(0错误弹窗提示,1飘字,2普通弹窗提示)	繁体中文	英文	韩文	日文	越南文	泰文
Key	Cn	TipType	Tw	En	Ko	Ja	Vi	Th
EC_SUCCESS	成功	0						
connect_time_out	连接超时!	1						
SystemError	服务器处理中，请稍后再试	0						
EC_SYSTEMERROR	服务器处理中，请稍后再试	0						
achieve_integral_no_enough	已领取该条目奖励	0						
achieve_lib_refresh_corps_achieve_rmb	数据异常，请稍后再试	1						
achieve_not_completed	任务没有完成	0						
achieve_not_found	无指定活动	0						
achieve_timeout	任务已经超时	0						
achieve_already_finish	任务已经领奖	0						
active		0						
ActivityTroopTips	是否立即领取!	0						
alread_garray	此武将已经上阵	0						
already_ally	此条请求已经失效	0						
already_exist	已经解锁此头像	0						
already_get	今日已经领取	0						
already_have	已经拥有该皮肤	0						
already_put_the_equipment	此装备已经穿上	0						
already_put_the_treasure	宝物已经佩上	0						
already_start	日常任务已经开始	0						
alredy_help	已经帮助过此条	0						
arena		0						
arena_fight_limit	挑战数据错误	0						
arena_garray_card_num_not_less_than_one	校武场防守阵容至少一位武将	0						
arena_lb_fight_enemy_charge_count	购买挑战次数不足	0						
arena_lb_fight_enemy_free_count	免费挑战次数不足	0						
arena_lb_fight_enemy_prop	校武牌不足	0						
arena_lb_fight_enemy_rmb	您当前的元宝不足	0						
arena_lb_refresh_enemy_charge_count	刷新次数不足	0						
arena_lb_refresh_enemy_free_count	免费刷新次数不足	0						
arena_lb_refresh_enemy_rmb	您当前的元宝不足	0						
arena_lib_award_day_f_win_num	累胜次数不足	0						
arena_lib_award_max_rank	历史排名不够	0						
arena_lib_check_card_in_garray_gid	武将在竞技场队列中上阵	0						
arena_lib_check_open_castle_lv	大殿等级不足	0						
arena_lib_fight_enemy_charge_count	购买挑战次数不足	0						
arena_lib_fight_enemy_free_count	免费挑战次数不足	0						
arena_lib_fight_enemy_prop	校武牌不足	0						
arena_lib_fight_enemy_rmb	您当前的元宝不足	0						
arena_lib_fight_prop	校武牌不足	0						
arena_lib_fight_rmb	您当前的元宝不足	0						
arena_lib_refresh_enemy_charge_count	刷新次数不足	0						
arena_lib_refresh_enemy_free_count	免费刷新次数不足	0						
arena_lib_refresh_enemy_rmb	您当前的元宝不足	0						
arena_no_normal	数据异常	0						
arena_not_open	校武场未开启	0						
arena_refresh_enemy_cd_time	换一批冷却时间未到	0						
arena_status	校武场奖励结算中	0						
arena_the_rank_fighting	该玩家正在战斗.请稍后重试	0						
back_result_no_normal	数据异常	0						
barracks_not_open	兵营未解锁	0						
barracks_num_limit	已达到储存兵力上限	0						
barracks_queue_full	队列已满	0						
barracks_time_limit	时间未到	0						
black_market_queue_full	队列已满	0						
born_point_error	预存的出生点坐标已经使用完,随机获取坐标时候由于多个玩家获取同一个可使用的坐标了导致写point_state失败	0						
breach_num_error	宝物突破消耗宝物数量不足	0						
building		0						
building_card_dispatched	该武将已经被派遣	0						
building_card_dispatching	含已派遣武将无法分解	0						
building_dispatched	该建筑已经有派遣武将	0						
building_lib_barracks_cb_forage	招募粮草不足	0						
building_lib_barracks_forage	粮草不足	0						
building_lib_barracks_iron	铁锭不足	0						
building_lib_barracks_mineral	矿石不足	0						
building_lib_barracks_money	铜币不足	0						
building_lib_barracks_rmb	立即完成元宝不足	0						
building_lib_barracks_wood	木材不足	0						
building_lib_black_market_building_type	建筑等级不满足	0						
building_lib_black_market_forage	收购需要粮草不足	0						
building_lib_black_market_iron	收购需要铁锭不足	0						
building_lib_black_market_mineral	收购需要矿石不足	0						
building_lib_black_market_rmb	收购需要元宝不足	0						
building_lib_black_market_wood	收购需要木材不足	0						
building_lib_building_dispatch_dispatched	武将不满足派遣要求	0						
building_lib_building_dispatch_special_effects_limit	武将特技与部门不匹配	0						
building_lib_building_dispatch_vacancy	可派遣位置不足	0						
building_lib_buy_tmp_queue_rmb	您当前的元宝不足	0						
building_lib_mintage_forage	铸币需要的粮草不足	0						
building_lib_mintage_iron	铸币需要的铁锭不足	0						
building_lib_mintage_mineral	铸币需要的矿石不足	0						
building_lib_mintage_wood	铸币需要的木材不足	0						
building_lib_reduce_queue_time_prop	加速道具不足	0						
building_lib_study_building	升级需要前置建筑等级不足	0						
building_lib_study_building_type	升级需要前置建筑等级不足	0						
building_lib_study_forage	升级需要粮食不足	0						
building_lib_study_iron	升级需要铁锭不足	0						
building_lib_study_mineral	升级需要石料不足	0						
building_lib_study_money	升级需要铜币不足	0						
building_lib_study_rmb	立即完成元宝不足	0						
building_lib_study_role_lv	升级需要角色等级不足	0						
building_lib_study_study	升级需要前置科技等级不足	0						
building_lib_study_wood	升级需要木材不足	1						
building_lib_treasure_house_prop	物品不足	0						
building_lib_treasure_house_unlock_cell_chapter	剧本不满足	0						
building_lib_treasure_house_unlock_cell_duplicate	尚未通过指定演武副本	0						
building_lib_treasure_house_unlock_cell_event_chapter	大殿等级不足	0						
building_lib_treasure_house_unlock_cell_event_duplicate	尚未通过指定演武副本	0						
building_lib_treasure_house_unlock_cell_event_main_building_level	大殿等级不足	0						
building_lib_treasure_house_unlock_cell_event_official	爵位等级不满足	0						
building_lib_treasure_house_unlock_cell_event_role_lv	主公等级不满足	0						
building_lib_treasure_house_unlock_cell_forage	粮草不足	0						
building_lib_treasure_house_unlock_cell_iron	铁锭不足	0						
building_lib_treasure_house_unlock_cell_main_building_level	解锁藏宝阁需要的大殿等级不足	0						
building_lib_treasure_house_unlock_cell_main_lv	解锁藏宝阁需要的大殿等级不足	0						
building_lib_treasure_house_unlock_cell_mineral	石料不足	0						
building_lib_treasure_house_unlock_cell_money	铜币不足	0						
building_lib_treasure_house_unlock_cell_official	爵位等级不满足	0						
building_lib_treasure_house_unlock_cell_prop	行商印不足	0						
building_lib_treasure_house_unlock_cell_rmb	您当前的元宝不足	0						
building_lib_treasure_house_unlock_cell_role_lv	主公等级不满足	0						
building_lib_treasure_house_unlock_cell_wood	木材不足	0						
building_lib_up_building	升级需要前置建筑等级不足	0						
building_lib_up_building_type	升级需要前置建筑等级不足	0						
building_lib_up_forage	升级需要粮草不足	1						
building_lib_up_iron	升级需要铁锭不足	1						
building_lib_up_mineral	升级需要矿石不足	1						
building_lib_up_money	升级需要铜币不足	1						
building_lib_up_rmb	您当前的元宝不足	1						
building_lib_up_role_lv	主公等级不满足	0						
building_lib_up_wood	升级需要木材不足	1						
building_lib_weapon_create_building_type	建筑等级不足	0						
building_lib_weapon_create_forage	粮食不足	0						
building_lib_weapon_create_iron	铁锭不足	0						
building_lib_weapon_create_mineral	石料不足	0						
building_lib_weapon_create_wood	木材不足	0						
building_max_level	建筑等级已达到当前上限	0						
building_no_up_info	没有升级信息	0						
building_queue_full	升级队列已满	0						
building_queue_ing	升级中	0						
building_queue_used	建筑队列正在使用中	0						
building_resource_full	资源已满不能收取	0						
building_time_limit	时间未到	0						
building_unlock	该建筑未解锁,不能升级	0						
buy_error	体力或繁荣已满	0						
buy_haved	您已经购买了开服基金	0						
can_not_accept	不可同时接取两个相同的任务	0						
can_not_attack_role_in_the_same_PowerCt	集结诏令颁布期间不能攻击同势力玩家	0						
card		0						
card_dispatching	有武将在派遣中，无法分解/重置	0						
card_level_max	武将已经满级	0						
card_lib_cards_card_level	等级不满足	0						
card_lib_cards_card_new_star	武将当前星级不满足	0						
card_lib_cards_card_star	武将星级不满足	0						
card_lib_cards_card_star_grid	武将星格不满足	0						
card_lib_cards_card_state	武将状态不满足	0						
card_lib_star_grid_money	铜币不足	0						
card_lib_star_grid_prop	材料不足	0						
card_lib_up_star_card_level	武将升星等级不满足	0						
card_lib_up_star_card_part	武将好感不足	0						
card_lib_up_star_money	铜币不足	0						
card_lib_up_star_reset_rmb	您当前的元宝不足	0						
card_lib_up_streng_card_level	武将等级不足	0						
card_lib_up_streng_card_star	武将星级不满足	0						
card_lib_up_streng_money	铜币不足	0						
card_new_star_max	武将升星已满	0						
card_not_idle	此武将不是空闲状态	2						
card_soldiers_limit	武将可带最大兵力不足	0						
card_star_max	卡牌星级已满	0						
card_no_reuse	相同武将已上阵	0						
cash		0						
cash_award_cash	充值金额不足	0						
cash_lib_cash_award_cash	充值数不满足	0						
castle_lib_move_castle_prop	迁城道具不足	0						
castle_lib_move_castle_rmb	您当前的元宝不足	0						
castle_protect_state	主城处于保护状态不能侦查	0						
cb_forage_not_enough	粮草不足	0						
cb_mineral_upper	石料已满,无法继续操作	0						
cd_limit	解散结盟冷却中	0						
cd_time_limit	插军旗cd时间限制	0						
chapter		0						
chapter_task		0						
chapter_task_lib_get_task_building	指定建筑等级不满足	0						
chapter_task_not_check_over	任务还没有完成	0						
chapter_task_was_award	已经领取过了	0						
chat		0						
chat_channel_cd	发言时间尚未冷却	0						
chat_max_times	刷新期内聊天次数已满	0						
chat_role_in_blanck	该玩家已被您拉黑	0						
chief_town_limit	拥有郡城数量不足	0						
collect_max	收藏个数达到上限	0						
consume_enough	条件不足	0						
consume_limit	消耗不足	0						
consume_not_enough	更名简不足	0						
corps		0						
corps_cd_limit	加入联盟冷却时间未到	0						
corps_cd_limitn	加入联盟的冷却时间未到	0						
corps_in_cross_battle	联盟当前正在进行史鉴之战	0						
corps_in_fighting	当前处于战斗状态，暂时不能操作	0						
corps_invite_num_limit	联盟最大邀请人数已达上限	0						
corps_invote_only_PowerCt	只能邀请与自己同一势力的人	0						
corps_lib_change_banner_rmb	联盟更换旗帜所需的元宝不足	0						
corps_lib_change_name_prop	暂无联盟更名简，无法更名	0						
corps_lib_corps_gift_get_num	接受次数限制，赠送失败	0						
corps_lib_corps_gift_prop	道具不足，赠送失败	0						
corps_lib_corps_gift_prop_num	道具数量不匹配	0						
corps_lib_corps_gift_prop_type	所选道具不能赠送，赠送失败	0						
corps_lib_corps_gift_rmb	元宝不足，不能赠送	0						
corps_lib_corps_gift_send_num	赠送次数限制，赠送失败	0						
corps_lib_corps_gift_vip_lv	VIP等级不足，不能赠送	0						
corps_lib_create_main_building_level	大殿等级不足	0						
corps_lib_create_money	铜币不足	0						
corps_lib_create_rmb	元宝不足	0						
corps_lib_create_role_level	主公等级不足	0						
corps_lib_create_vip	vip等级不足	0						
corps_lib_donate_contribute_times	联盟接受捐献次数已达到本日上限	0						
corps_lib_donate_money	铜币不足	0						
corps_lib_donate_rmb	元宝不足	0						
corps_lib_enter_castle_level	该联盟需要更高的大殿等级，方能加入	0						
corps_lib_enter_main_building_level	主公府等级不足	0						
corps_lib_enter_role_level	该联盟需要更高的大殿等级，方能加入	0						
corps_lib_replace_owner_offline_sec	联盟长离线时间没达到要求	0						
corps_lib_replace_rmb	元宝不足	0						
corps_lv_limit	联盟等级不足	0						
corps_member_num_limit	成员数达到上限	0						
corps_name_exist	名字已经存在	1						
corps_no_invite	邀请已失效	1						
corps_not_find	该联盟已解散	1						
corps_not_in	不在联盟中	0						
corps_not_member	没有该成员	0						
corps_not_request	该请求不存在	1						
corps_only_replace_owner	替代联盟长不满足	0						
corps_position_limit	权限不足	1						
corps_position_not_quit	该职位不允许退出	0						
corps_request_num_limit	该联盟申请人数过多	0						
corps_request_only_PowerCt	只能申请自己势力的联盟	0						
corps_role_invite_num_limit	玩家被联盟同时邀请的次数达到上限	0						
corps_role_request_num_limit	您申请的联盟数量已经达到上限	0						
corps_search_by_name_cd_limit	搜索冷却时间未到	0						
corps_town_abandon_times_limit	可放弃的城池数量达到上限	0						
corps_town_is_abandoning	城池放弃中,不能进行该操作	0						
corps_town_not_owner	该城池已被别的联盟攻占，您已失去了对该城池的放弃权！	0						
corps_town_state_error	该城池非和平状态，无法放弃。	0						
corps_town_state_error2	该城池非和平状态，无法取消放弃。	0						
corps_vice_owner_num_limit	副团长人数达到上限	0						
corps_was_in	您已经在联盟中	0						
corps_was_request	已经发送过请求	0						
count_max	捐献次数已经达到上限	0						
create_num_limit	建造数量已达上限	0						
create_town_not_owner	城池属于不属于联盟	0						
cross_battle		0						
cross_battle_corps_not_in	联盟没有参加跨服	0						
cross_battle_lib_transfer_consume_prop	联盟跨服战划拨消耗物品不足	0						
cross_battle_lib_transfer_consume_rmb	联盟跨服战划拨消耗元宝不足	0						
cross_battle_not_find	没有跨服	0						
cross_battle_not_open	跨服没有开启	0						
cross_battle_num_limit	抽卡次数超标	0						
cross_battle_rank_limit	排名不达标	0						
ctb_day_max_limit	捐献已达上限	0						
ctb_max_limit	捐献超过上限值	0						
data_error	数据异常	0						
day_construction_limit	今日元宝捐献次数已用完	0						
day_max	今日次数已用完	0						
del_mail_error	没有可删除的邮件	0						
donate_num_limit	物资捐献已达上限	0						
duplicate		0						
duplicate_lib_duplicate_award_box_node	领取条件不满足	0						
duplicate_lib_famous_duplicate_change_card_node	前置副本未通关	0						
duplicate_lib_famous_duplicate_change_card_reset	名将副本换将次数不足	0						
duplicate_lib_famous_duplicate_change_card_rmb	名将副本重置所需的元宝不足	0						
duplicate_lib_fight_day_num	每日挑战次数已达上限	0						
duplicate_lib_fight_node	前置副本未通关	0						
duplicate_lib_fight_pve	体力不足	0						
duplicate_lib_fight_pvp	副本战斗行军令不满足	0						
duplicate_lib_fight_role_level	副本战斗玩家等级不满足	0						
duplicate_lib_fight_star	副本战斗星星条件不满足	0						
duplicate_lib_fight_vip_level	副本战斗玩家VIP等级不满足	0						
duplicate_lib_fight2_public_day_count	挑战次数不足	0						
duplicate_lib_reset_num_node	前置副本未通关	0						
duplicate_lib_reset_num_reset	重置次数不足	0						
duplicate_lib_reset_num_rmb	元宝不足	0						
duplicate_lib_sweep_day_num	副本扫荡次数不足	0						
duplicate_lib_sweep_public_day_count	同类型副本每天最大挑战次数不足	0						
duplicate_lib_sweep_pve	体力不足	0						
duplicate_lib_sweep_pvp	副本扫荡行军令不满足	0						
duplicate_lib_sweep_role_level	副本扫荡玩家等级不满足	0						
duplicate_lib_sweep_star	副本扫荡星级条件不满足	0						
duplicate_lib_sweep_vip_level	副本扫荡VIP等级不满足	0						
duplicate_no_normal	副本格式化战斗数据异常	0						
duplicate_star_awarded	奖励已领取	0						
duplicate_star_limit	领取奖励所需的星数不满足	0						
enemy_garray_queue_null	这个玩家的防守阵容数据为空,不能战斗	0						
equipment		0						
equipment_already_max	装备已经满级	0						
equipment_lib_active_building_type	激活图纸，检测要求的建筑类型的任意1建筑的等级不满足	0						
equipment_lib_active_prop	激活图纸，道具不满足	0						
equipment_lib_put_equipment_card_level	武将等级不足	0						
equipment_lib_put_equipment_role_level	主公等级不足	0						
equipment_lib_up_streng_iron	强化所需铁锭不足	0						
equipment_lib_up_streng_money	铜币不足	0						
equipment_storage_full	装备包裹空间不足	0						
error_ally_corps_uid	解散结盟的联盟uid错误	0						
error_input	数据异常，请稍后再试	1						
exchange		0						
exchange_db_exchange_prop	材料不足	0						
exchange_db_exchange_role_money	铜币不足	0						
exchange_lib_exchange_building_type	合成兑换物品建筑类型不满足	0						
exchange_lib_exchange_equipment_forge	合成兑换物品装备图纸不存在	0						
exchange_lib_exchange_money	铜币不足	0						
exchange_lib_exchange_prop	材料不足	0						
exist	已存在角色	1						
exist_mole_role_uid	目标已经是内奸	0						
exist_same_card_sid	存在相同武将	0						
exist_sid	已领取过同sid任务	0						
fight		0						
fight_boss_num_limit	今日挑战次数已达上限！	0						
fight_db_investigate_soldier_num	侦查部队数不足	0						
fight_lib_speed_up_money	铜币不足	0						
fight_lib_speed_up_prop	加速道具不足	0						
fight_lib_speed_up_rmb	您当前的元宝不足	0						
fight_state	有武将为出战状态	0						
fighting	战斗中	0						
fighting_no_normal	fighting战斗格式化战斗数据异常	0						
friend_garrays_exist	当前有友军驻防中，不能进行迁城	0						
function_no_open	gm工具关闭了校武场	0						
function_not_open	功能暂未开放！	0						
funds		0						
funds_lib_award_buy_number	购买开服基金次数数不足	0						
funds_lib_award_funds	没有购买开服基金	0						
funds_lib_award_level	开服领奖所需的主公等级不足	0						
funds_lib_buy_rmb	购买开服基金所需的元宝不足	0						
funds_lib_buy_vip	购买开服基金所需的vip等级不足	0						
game_center_activation_code_not_found	无效激活码	0						
game_center_activation_code_time_out	激活码不在有效期	0						
game_center_activation_code_type_error	激活码类型错误	0						
game_center_gift_code_not_found	礼包码格式不正确	1						
game_center_gift_code_time_out	该礼包码已过期	0						
game_center_gift_code_type_error	礼包码类型错误	0						
garraison_dispatching	已派遣驻防	0						
garray		0						
garray_error	选择该阵型不能出征	0						
garray_id_error	队伍ID错误	0						
garray_lib_new_change_card_building	上阵建筑等级不足	0						
garray_lib_new_change_card_level_barracks	提升中军帐等级可以增加上阵武将数量	0						
garray_lib_new_change_card_level_ordnance	上阵器械数量已达最大	0						
garray_lib_new_change_card_level_role	主公等级不足	0						
garray_lib_new_change_card_main_lv	大殿等级不足	0						
garray_lib_new_change_card_role_lv	等级不足	0						
garray_lib_new_change_card_study	上阵科技等等级不足	0						
garray_lib_set_skill36_bstudy_lv	计略府等级限制	0						
garray_lib_set_skill36_building_sid	计略府等级不足	0						
garray_lib_set_skill36_card_record	计略解锁效果条件限制	0						
garray_lib_set_skill36_study_lv	计略等级限制	0						
garray_marching_state	有部队在外不能迁城	0						
garray_not_idle	该队伍当前不可编辑	0						
garray_not_recall	该队伍当前不可召回	0						
garray_ordnance_max_error	上阵器械数量已达最大	0						
garray_queue_null	自己防守阵容为空不能战斗	0						
garray_soldier_type_limit	兵种限制	0						
garray_state	有友军军队不可迁城	0						
garrison_friends_num_limit	对方友军驻防数量达到上限	0						
garrison_no_dispatch	没有这个驻防队伍	0						
garrison_no_friend_array	该友军队伍不存在	0						
garrison_no_friend_garray	没有这个好友驻防队伍	0						
garrison_no_recall	该队伍不能召回	0						
getpve_awarded	已经领取过该宝箱	0						
getpve_lib_getpve_rmb	消耗元宝不足	0						
getpve_lib_getpve_time	不在领取时间段	0						
gift_id_error	礼包id错误	0						
gift_lib_check_count	已使用过该类型礼包码	0						
gift_lib_check_gift_time	该礼包码已过期	0						
gift_lib_check_parent_count	礼包码使用个数已达上限	0						
gift_lib_check_platform_id	该礼包码无法使用	0						
gift_lib_check_role_count	礼包码领取已达上限	0						
gift_lib_check_use_count	礼包码可使用次数不足	0						
gift_lib_gift_award_count	您已领取过该类型的礼包码	0						
gift_lib_gift_award_gift_time	该礼包码已过期	0						
gift_lib_gift_award_ios_android	礼包码使用平台限制	0						
gift_lib_gift_award_parent_count	礼包码使用个数已达上限	0						
gift_lib_gift_award_platform_id	该礼包码使用平台受限	0						
gift_lib_gift_award_role_count	礼包码领取已达上限	0						
gift_lib_gift_award_use_count	该礼包码已被使用	0						
gift_lib_role_activation_conditions_gift_time	激活码不在有效期	0						
gift_lib_role_activation_conditions_ios_android	平台错误	0						
gift_lib_role_activation_conditions_platform_id	渠道错误	0						
gift_lib_role_activation_conditions_use_count	激活码已使用	0						
give_up_daymax	每日放弃任务次数已达上限	0						
goods_not_enough	要消耗的物品不足	0						
got_position_award	当天已领取次数	0						
grid_is_activited	该天赋已经激活	0						
grid_not_full	天赋没有全部激活	0						
grid_not_this_star	天赋传入sid错误	0						
group_does_not_belong_with_corps	军团不属于联盟	0						
group_not_exist	军团不属于联盟	0						
group_name_exist	军团名字已存在	0						
have_awarded	该奖励已经领取	0						
have_conutry	已经选取过势力	0						
have_point	已经有了出生点	0						
have_emoji	存再特殊字符	0						
have_mask_word	含有敏感词，请重新输入	1						
horn		0						
horn_alone	由于你的发言存在非法信息，请联系客服	0						
horn_cross_error	中控没有配置	0						
horn_lib_send_horn_cd	喇叭冷却时间尚未结束	0						
horn_lib_send_horn_prop	物品不足	0						
horn_lib_send_horn_role_level	主公等级不满足	0						
horn_lib_send_horn_vip_level	主公VIP等级不满足	0						
in_use	此皮肤正在使用	0						
index_error	当前位置已经没有武将	0						
index_info_type_error_ordnance	当前位置对应的不是器械	0						
injured_limit	伤兵数量不足	0						
input_error	数据异常，请稍后再试	1						
input_uid_error	没有找到这个玩家的校武场数据	0						
ld_consume_not_enough	消耗不足	0						
ld_day_max	已达到本日次数上限	0						
ld_day_times_limit	次数不足	0						
ld_lib_draw_card_storage	可容纳武将的空间不足	0						
ld_lib_draw_cross_battle_num	执行抽奖跨服战次数不满足	0						
ld_lib_draw_free_times	免费次数不足	0						
ld_lib_draw_money	铜币不足	0						
ld_lib_draw_mount_storage	执行抽奖坐骑包裹空间不足	0						
ld_lib_draw_officer_silver	玉璜不足	0						
ld_lib_draw_prop	物品不足	0						
ld_lib_draw_rmb	元宝不足	0						
ld_lib_draw_role_level	等级不足	0						
ld_lib_draw_vip_level	vip等级不足	0						
leisure_limit	空闲士兵不足	0						
leisure_weapon_not_enough	空闲兵器不足	0						
level_limit	主公等级不足	0						
level_limit_1	世界频道聊天主公等级不足	0						
level_limit_2	私聊频道聊天主公等级不足	0						
level_limit_3	联盟频道聊天主公等级不足	0						
level_limit_4	势力频道聊天主公等级不足	0						
limit_count	当前服务器人数过多	0						
limit_create	该服务器已满，请您选择其他服务器进行游戏	1						
limit_login	服务器限制登录	0						
log_not_exist	战报不存在	0						
look		0						
look_goback	寻访队伍已返回	0						
look_lib_check_condition_attr	寻访队伍所有武将属性不满足	0						
look_lib_check_condition_card_lv	寻访队伍有武将等级不满足条件	0						
look_lib_check_condition_power	寻访队伍战力不满足	0						
look_lib_check_condition_soldiers_num	寻访队伍总兵力不满足	0						
look_lib_look_forage	寻访粮草不满足	0						
look_times_limit	可寻访次数不足(寻访点可以被寻访的次数已经没有了)	0						
lucky_draw		0						
lv_limit	主公等级不足	0						
mail		0						
mail_leng	当日购买数量上限	0						
mail_not_exsit	该邮件不存在	0						
main_building_level_1	大殿达到7级开放世界频道	1						
main_building_level_2	大殿达到3级开放私聊频道	1						
main_building_level_4	大殿达到5级开放势力频道	1						
main_building_not_dispatch	大殿不能派遣	0						
map_battle_spy_lib_spy_recruit_rmb	招募消耗的rmb不足	0						
map_build		0						
map_build_creating	地图建筑建设中	0						
map_build_donate_limit	建筑捐献限制	0						
map_build_fly_cd	冲车营击飞冷却限制	0						
map_build_level_limit	建筑等级限制	0						
map_build_lib_cancel_destroy_corps_position	取消建筑摧毁所需的权限不足	0						
map_build_lib_create_cb_forage	建设地图建筑跨服粮草不足	0						
map_build_lib_create_cb_iron	建设地图建筑跨服铁不足	0						
map_build_lib_create_cb_mineral	建设地图建筑跨服石料不足	0						
map_build_lib_create_cb_wood	建设地图建筑跨服木材不足	0						
map_build_lib_create_corps_lv	联盟等级不足	0						
map_build_lib_create_corps_position	权限不足	0						
map_build_lib_create_donate	捐献值不足	0						
map_build_lib_create_town_lv	城池等级不足	0						
map_build_lib_create_town_owner	城池不属于己方联盟	0						
map_build_lib_destroy_corps_position	权限不足	0						
map_build_lib_donate_cb_iron	建筑捐献跨服铁锭不足	0						
map_build_lib_donate_cb_mineral	建筑捐献跨服石料不足	0						
map_build_lib_donate_cb_wood	建筑捐献跨服木材不足	0						
map_build_lib_donate_iron	建筑捐献铁锭不足	0						
map_build_lib_donate_mineral	建筑捐献石料不足	0						
map_build_lib_donate_wood	建筑捐献木材不足	0						
map_build_lib_fly_corps_position	收取冲车营效果联盟职位不足	0						
map_build_lib_removal_cd	搬迁当前处于冷却中	0						
map_build_lib_removal_corps_position	权限不足	0						
map_build_lib_removal_rmb	搬迁元宝不足	0						
map_build_lib_create_map_build_for_sgz2_role_lv	建筑创建玩家等级不足	0						
map_build_lib_create_map_build_for_sgz2_main_building_level	建筑创建大殿等级不足	0						
map_build_lib_create_map_build_for_sgz2_wood	建筑创建木材不足	0						
map_build_lib_create_map_build_for_sgz2_mineral	建筑创建矿石不足	0						
map_build_lib_create_map_build_for_sgz2_iron	建筑创建铁锭不足	0						
map_build_lib_create_map_build_for_sgz2_forage	建筑创建粮食不足	0						
map_build_lib_repair_wood	建筑修复木材不足	0						
map_build_lib_repair_mineral	建筑修复矿石不足	0						
map_build_lib_repair_iron	建筑修复铁不足	0						
map_build_lib_repair_forage	建筑修复粮食不足	0						
map_build_lib_uplevel_for_sgz2_wood	建筑升级木材不足	0						
map_build_lib_uplevel_for_sgz2_mineral	建筑升级矿石不足	0						
map_build_lib_uplevel_for_sgz2_iron	建筑升级铁不足	0						
map_build_lib_uplevel_for_sgz2_forage	建筑升级粮食不足	0						
map_build_lib_uplevel_for_sgz2_main_building_level	建筑升级大殿等级不足	0						
map_build_lib_uplevel_for_sgz2_role_lv	建筑升级玩家等级不足	0						
map_build_max_lv	建筑已经最大等级	0						
map_build_not_owner	建筑不是自己联盟所有	0						
map_build_not_yours	不是自己建筑或建筑不存在	0						
map_build_state_limit	建筑状态限制	0						
map_build_not_distory	建筑没在销毁状态中	0						
map_build_not_up	建筑没在升级状态中	0						
map_build_max_num_limit	建筑最大个数限制	1						
map_build_bvalue_is_full	建筑耐久度已达最大值，不能修复	0						
map_spy_lib_spy_recruit_cb_forage	招募消耗的粮草不足	0						
marching_add_speed_times	行军加速次数不足	0						
marching_max	行军数达到最大	0						
match_port_no_normal	战斗结算的时候并没有战斗数据	0						
max_exp	此科技已经满级	0						
max_group_num	军团数量达到上限	0						
max_mole_size	内奸数量已经达到最大值	0						
max_num_limit	可拥有侦查兵的最大数量超限	0						
max_number_limit	士兵总数超过上限	1						
max_position_award_0	联盟长的俸禄今日已被领取	0						
max_position_award_1	副联盟长的俸禄今日已被领取	0						
mintage_time_limit	时间未到	0						
mole_role_uid_error	目标角色uid错误	0						
monarch_corps_exist	该联盟已接受其他诏令	0						
monarch_has_king	已经有君主	0						
monarch_not_find_corps	联盟没有找到	0						
monarch_not_police	没有找到诏令	0						
monarch_only_king_op	只有君主才能操作	0						
monarch_role_has_official	玩家已有官职	0						
monarch_role_not_official	玩家没有职位	0						
monarch_set_official_cd	职位冷却中	0						
monarch_town_owner_error	都城不属于自己联盟	0						
money_donate_num_limit	今日联盟铜币捐献名额已用完	1						
month_card_end	月卡已过期	0						
mount		0						
mount_in_card	坐骑已经穿戴	0						
Mount_level_max	坐骑等级达到最大	0						
mount_lib_forging_money	锻造合成铜币不足	0						
mount_lib_forging_prop	锻造合成物品不足	0						
mount_lib_put_equipment_mount_level	穿戴装备坐骑等级不足	0						
mount_lib_reduce_queue_time_prop	锻造减少队列时间物品不足	0						
mount_not_in_this_card	坐骑主人不是这个武将	0						
name_length_err	输入字符过长	0						
no_abandoing_town	没有放弃中的城池	0						
no_barracks	没有招募/治疗信息	0						
no_born_point	该势力人数已达上限,请选择其他势力创建	0						
no_card	角色没有此武将	0						
no_chat	当前无法聊天	0						
no_collect	没有人在采集	0						
no_corps	没有联盟	0						
no_equipment	角色没有此装备	0						
no_famous_general	没有名将挑战	0						
no_help_info	没有帮助信息	0						
no_idle	队伍不为空闲状态	0						
no_in_corps	没有在联盟中	0						
no_login	网络连接中断,请重新登录	0						
no_login_cross_server	表示不能登录跨服服务器	0						
no_look	没有寻访信息	0						
no_map_build	建筑已消失	0						
no_marching	没有行军信息	1						
no_mintage	没有铸币信息	0						
no_month_card	没有月卡	0						
no_mount	uid对应的坐骑不存在	0						
no_old_enemy	原排名玩家数据错误	0						
no_permissions	没有权限	0						
no_point	没有坐标	0						
no_push_gift	没有限时推送礼包事件	0						
no_qid	此队列未解锁	0						
no_queue	没有找到队列	0						
no_recruit	没有招募队列	0						
no_role	角色不存在	1						
no_role_trust	角色不存在	1						
no_science	没有已学习的科技	0						
no_server_name	sdk错误,请重新登录	0						
no_skill36	没有该计略	0						
no_station	没有驻扎/驻防	0						
no_style	没有此头像	0						
no_this_achieve	没有这个任务	0						
no_this_mole	这个玩家不是内奸	0						
no_treasure	没有此宝物	0						
no_treasure_house_or_black_market	藏宝阁或者黑市没有解锁	0						
no_trust	不在托管状态	0						
no_user_trust	该帐号不存在	0						
normal_town_limit	郡城城池占有数量不足	0						
not_chapter_task_sid	没有这个任务	0						
not_enough_count	设置次数不足	0						
not_enough_permission	没有设置内奸的权限	0						
not_first_enter_corps	不是第一次加入联盟	0						
not_first_fight	不是第一次打怪	0						
not_have_this_skin	没有拥有此皮肤	0						
not_in_same_corps	玩家不在同一联盟，赠送失败	0						
not_in_the_area	不在指定范围内	0						
not_open	功能没有开放！	0						
not_own	玩家此头像未解锁	0						
not_same_PowerCt	和目标角色不在一个势力	0						
not_the_owner_of_the_flag	玩家不是这个军旗的军棋手	0						
not_the_same_PowerCt	非同势力联盟，无法结盟！	0						
null_chapter_task	章节任务为空	0						
number_not_enough	兵器数量不足	0						
official		0						
official_error	爵位信息错误	0						
official_lib_time_up_official_rank_limit	定时排行榜更新检查排行榜限制	0						
official_lib_up_official_rank_limit	自动升官职排行榜限制	0						
rank_forbidden	禁止参与排行榜，解封时间为%s	0						
once_num_limit	一次可招募数量超限	0						
one_number_limit	已达到一次招兵/治疗伤兵上限	0						
online_award_lose	不可领取	0						
online_award_over	已经领取过	0						
online_award_refresh	已经领取完	0						
online_award_time_limit	时间不足	0						
order_id_error	订单id重复	0						
ordnance_cannot_use	器械不能使用	0						
ordnance_num_limit	上阵器械数量已达最大	0						
other_already_ally	对方已经结盟	0						
other_card_put	该宝物已被穿戴	0						
other_cd_limit	对方解散结盟冷却中	0						
petition		0						
petition_lib_add_point_brains	武将智力不满足	0						
petition_lib_add_point_event_is_over	陈情事件已经完成	0						
petition_lib_add_point_event_sid	陈情没有这个事件id	0						
petition_lib_add_point_forage	完成陈情事件的总粮草不满足	0						
petition_lib_add_point_force	武将武力不满足	0						
petition_lib_add_point_govern	武将统率不满足	0						
petition_lib_add_point_iron	铁锭不足	0						
petition_lib_add_point_mineral	石料不足	0						
petition_lib_add_point_wood	木材不足	0						
petition_lib_reset_point_add_number	重置陈情潜能点时，已增加的总点数不足	0						
petition_lib_reset_point_rmb	重置潜能点所需的元宝不足	0						
petition_no_open	陈情功能未开放	0						
pid_disable	该账号已被禁用	0						
point		0						
point_error	坐标错误	0						
point_exist	此坐标已经收藏	0						
point_not_exist	此坐标点不存在	0						
point_not_null	目标位置不是空地	0						
point_null	表示该点为空地,不能攻打	0						
political_card_exist	武将已在其他位置上阵	0						
political_cd	内政冷却时间未到	0						
political_day_max	内政使用次数已经达到上限	0						
political_pos_not_empty	位置已经上阵	0						
pos_in_queue	队列已存在	0						
pos_not_empty	该位置有建筑物	0						
prop_not_enough	物品数量不足	0						
prop_not_sell	该物品不能出售	0						
prop_use_value_limit	使用后超出获得值类型上限	0						
push_gift		0						
push_gift_active_lib_open_condition_interval_time	活动间隔时间不足	0						
push_gift_active_lib_open_condition_one_codition	条件不满足	0						
push_gift_id_error	没有限时推送礼包事件	0						
push_gift_lib_buy_buy_time	不在可购买时间内	0						
push_gift_lib_buy_cash	人民币直接购买,接口错误	0						
push_gift_lib_buy_money	铜币不足	0						
push_gift_lib_buy_rmb	您当前的元宝不足	0						
push_gift_lib_buy_times	购买次数已达上限	0						
pve_max	超过最大上限不可领取	0						
pvp_not_enough	行军令不足够	0						
qid_already_queue	此队列编号已经在队列中	0						
queueing_cancel_limit	建筑升级中,不可取消或派遣	0						
Receive_error	错误	0						
recovery_value_limit	恢复类型的值达到上限	0						
recruiting	有招募在进行中	0						
refresh_num_limit	联盟任务每天最大刷新次数达到上限	0						
repair_bag_not_enough	修理包不足	0						
repair_num_limit	器械修理包数量不足	0						
report		0						
report_failed	该战报已失效	1						
report_lib_revenge_prop	复仇令不足	0						
report_lib_spy_cb_forage	粮食不足，无法进行侦查操作	0						
report_no_detail	该战报没有详细信息	0						
report_not_detail	没有战报详情	0						
report_not_found	该战报已失效	1						
request_valid_time_out	邀请信息已失效	0						
res_count_limit	民屯占领个数已达上限	0						
res_fighting	战斗中不能放弃	0						
res_lv_limit	资源点等级限制	0						
reset_time_limit	联盟重置城池科技冷却时间限制	0						
reset_time_not_arrive	科技重置时间限制	0						
resolve_lib_reset_quality	武将品质错误	0						
resolve_lib_reset_rmb	元宝不足	0						
resolve_lib_reset_state	武将出战状态	0						
rewarded	已领取过奖励	0						
rm_achieve_finish	当前任务已完成	0						
rmb_donate_num_limit	今日联盟金饼捐献名额已用完	1						
rmb_not_enough	您当前的元宝不足	0						
role		0						
role_gift_web_error	礼包码服务器错误	0						
role_level_not_enough	角色等级不足	0						
role_lib_free_role_lv	头像使用角色等级限制	0						
role_lib_free_vip_lv	头像使用VIP等级限制	0						
role_lib_style_unlock_role_lv	角色头像解锁玩家等级限制	0						
role_lib_style_unlock_vip_lv	角色头像解锁VIP等级限制	0						
role_lv_limit	主公等级不足	0						
role_not_find	没有找到该玩家	1						
role_protected	玩家保护状态中	0						
same_name	该名字已被注册	1						
same_style	与当前形象一样	0						
scene		0						
score_no_enough	积分不足	0						
server_starting	服务器启动中	0						
sex_error	性别错误	0						
shop_condition_limit	商店开启条件不足	0						
shop_db_checks_card_soul	信物不足	0						
shop_db_checks_corps_forever	已经达到购买上限	0						
shop_db_checks_corps_money	联盟名望不足	0						
shop_db_checks_day_max	当日购买数量上限	0						
shop_db_checks_forage	粮草不足	0						
shop_db_checks_forever	购买次数达到最大不足	0						
shop_db_checks_goods_storage	背包空间不足	0						
shop_db_checks_iron	铁锭不足	0						
shop_db_checks_mineral	石料不足	0						
shop_db_checks_money	铜币不足	0						
shop_db_checks_rmb	元宝不足	0						
shop_db_checks_role_level	等级不足	0						
shop_db_checks_shop_forever	校验该物品服务器可购买次数不足	0						
shop_db_checks_wood	木材不足	0						
shop_no_find_item	没有这个商品项	0						
shop_refresh_already_max	刷新次数限制	0						
shop_refresh_no_enough	当日商店刷新次数不足	0						
shutup	您的账号已被禁言，解封时间为%s	0						
sid_error	sid错误	0						
sid_is_unlocked	栏位未解锁	0						
sig_error	签名证书错误	0						
size_limit	字数超过上限	0						
size_limit_1	世界频道聊天内容大小限制	0						
size_limit_2	私聊频道聊天内容大小限制	0						
size_limit_3	联盟频道聊天内容大小限制	0						
size_limit_4	势力频道聊天内容大小限制	0						
skin		0						
skin_lib_deblocking_goods_use	只能通过使用道具获得	0						
skin_lib_deblocking_rmb	元宝不足	0						
skin_lib_deblocking_vip_level	VIP等级不足	0						
some_players_are_already_in_other_group	部分玩家在其他军团中	0						
some_players_are_already_in_the_group	部分玩家已经在当前军团中	0						
some_players_have_a_position	部分玩家已经有职位	0						
some_players_is_group_owmer	部分玩家是军团长	0						
some_players_no_in_group	部分玩家不在军团	0						
some_players_no_in_this_group	部分玩家不在当前军团	0						
station		0						
station_gid_marching	驻扎点队伍行军中	0						
station_num_limit	玩家同时驻扎点个数限制	0						
storage_full	背包已满	1						
study_max_lv	研究已达到最大上限	0						
study_no_up_info	没有升级信息	0						
study_queue_full	升级队列已满	0						
study_queue_ing	研究队列升级中	0						
study_time_limit	时间未到	0						
SystemError	服务器处理中，请稍后再试	0						
task_is_end_award	任务已结束	0						
task_not_find	没有这个任务	0						
task_not_finish	任务还没有完成	0						
task_not_start_award	任务没有开始领奖	0						
task_was_award	任务已经领奖	0						
the_PowerCt_corps_animate_num_limit	同势力联盟数量限制（同一势力，有效联盟数量限制）	0						
this_flag_lock	军旗未解锁	0						
time_error	时间错误	0						
time_limit	时间不足	0						
tmp_queue_len_limit	建筑队列个数达到上限	0						
tmp_queue_not_find	建筑队列没有找到	0						
tmp_queue_used	建筑队列使用中	0						
town		0						
town_achieve_accept_daymax	每天接取任务数量达到上限	0						
town_achieve_daymax	该活动未开启	0						
town_ahcieve_refresh	刚好12点领取任务时候,提示刷新任务	0						
town_fight_no_open	该城池不能攻打！	0						
town_fight_time_limit	时间未到	0						
town_lib_build_build_town_exp_max	建设后超出城池经验上限	0						
town_lib_build_construction_rmb	元宝不足！	0						
town_lib_build_corps_material	联盟建设资材不足	0						
town_lib_duplicate_box_awarded	已经领取	0						
town_lib_duplicate_lib_duplicate_award_box_node	关卡未通关	0						
town_lib_duplicate_lib_fight_day_num	今日次数不足	0						
town_lib_duplicate_lib_fight_node	激活关卡未通关	0						
town_lib_duplicate_lib_fight_pve	体力不足	0						
town_lib_duplicate_lib_fight_pvp	行军令不足	0						
town_lib_duplicate_lib_fight_role_level	等级不足	0						
town_lib_duplicate_lib_fight_star	星数不足	0						
town_lib_duplicate_lib_fight2_public_day_count	公共次数已用完	0						
town_lib_duplicate_lib_reset_num_node	激活关卡未通关	0						
town_lib_duplicate_lib_reset_num_reset	重置次数用完	0						
town_lib_duplicate_lib_reset_num_rmb	元宝不足	0						
town_lib_duplicate_lib_sweep_day_num	今日扫荡次数已用完	0						
town_lib_duplicate_lib_sweep_public_day_count	扫荡次数已用完	0						
town_lib_duplicate_lib_sweep_pve	体力不足	0						
town_lib_duplicate_lib_sweep_pvp	行军令不足	0						
town_lib_duplicate_lib_sweep_role_level	等级不足	0						
town_lib_duplicate_lib_sweep_star	星数不足	0						
town_lib_duplicate_lib_sweep_vip_level	vip等级不足	0						
town_lib_duplicate_no_reset	不能重置关卡	0						
town_lib_duplicate_star_awarded	该奖励已经领取	0						
town_lib_duplicate_star_limit	星数不足	0						
town_lib_study_science_level_max	科技达到最大等级	0						
town_lib_study_science_must_science	前置科技未达到要求	0						
town_lib_study_science_science_point	城池剩余科技点不足	0						
town_lib_study_science_used_point	不满足条件	0						
town_lib_town_build_build_town_exp_max	联盟城池建设达到经验上限	0						
town_lib_town_build_construction_rmb	城池建设元宝不足	0						
town_lib_town_build_corps_material	城池建设资材不足	0						
town_lib_town_check_occupy_town_limit	占领城池数已达联盟上限	0						
town_lib_town_check_occupy_town_near	占领城池不是相邻郡	0						
town_lib_town_check_occupy_town_num	占领的该郡县城数量不足	0						
town_lib_town_contribute_contribute_times	捐献次数用完	0						
town_lib_town_contribute_forage	粮草不足	0						
town_lib_town_contribute_iron	铁锭不足	0						
town_lib_town_contribute_iron_limit	城池建设铁数量单位错误	0						
town_lib_town_contribute_max_science_schedule	已达当前科技点上限，无法捐献	0						
town_lib_town_contribute_mineral	石料不足	0						
town_lib_town_contribute_mineral_limit	城池建设石数量单位错误	0						
town_lib_town_contribute_wood	木材不足	0						
town_lib_town_contribute_wood_limit	城池建设木数量单位错误	0						
town_lib_town_exchange_ground_silver	洛阳碎银货币不足	0						
town_lib_town_study_science_must_science	学习的前置技能不满足	0						
town_lib_town_study_science_science_point	城池科技点不足	0						
town_lib_town_study_science_used_point	投入的技术点不足	0						
town_no_achieve_sid	该城池没有该任务	0						
town_no_sid	未找到该科技	0						
town_not_oneself	不是自己的城	0						
town_not_owner	城池不归自己联盟所有	0						
town_protect	城池保护冷却中	0						
treasure		0						
treasure_already_max	宝物已满级	0						
treasure_house_queue_full	藏宝阁的队列已满	0						
treasure_level_error	藏宝阁宝物突破所需的藏宝阁等级不足	0						
treasure_lib_put_treasure_card_level	穿戴宝物卡片等级不满足	0						
treasure_lib_up_streng_need_money	宝物货币不足	0						
treasure_lib_up_streng_treasure_money	宝物强化需要的宝物货币不足	0						
treasure_num_limit	宝物突破次数上限	0						
treasure_storage_full	宝物包裹空间不足	0						
treasure_streng_limit	宝物强化限制（包括了等级/所需材料/强化的宝物）	0						
trust_no_create	托管状态不可创建角色	0						
trusting	帐号被托管不可登录	1						
uid_error	没有找到这个玩家的校武场数据	0						
unlock_limit	解锁限制	0						
update_name_cd_limit	改名冷却时间尚未结束	0						
user_disable	由于您的帐号违规已被封停，解封时间为%s，如有疑问请联系客服。	0						
user_error	无用户数据	0						
warehouse_full	仓库已满	0						
wisdom_max	该才略已经满级	0						
wisdom_sid_error	才略sid错误	0						
world_office		0						
world_office_achieve_not_found	世界官职任务没找到	0						
world_office_lib_appoint_PowerCt	势力不一致	0						
world_office_lib_appoint_jurisdiction	任命权显示错误，请重新打开此界面	0						
world_office_lib_appoint_leave_office_PowerCt	势力不相同	0						
world_office_lib_appoint_leave_office_is_office	被卸任的角色没有官职	0						
world_office_lib_appoint_leave_office_jurisdiction	权限不足	0						
world_office_lib_appoint_open_limit	官职未解锁	0						
world_office_lib_appoint_target_office	被任命这个人必须没有职位 被任命的角色已存在官职	0						
world_office_lib_appoint_vacancy	职位没有空缺	0						
world_office_lib_declaration_content	宣言内容长度超限制	0						
world_office_lib_declaration_jurisdiction	权限不足	0						
world_office_lib_declaration_limit_time	宣言时间CD中	0						
world_office_lib_declaration_mask	含有敏感词，请重新输入	1						
world_office_lib_get_PowerCt_task_is_give	已经领取奖励	0						
world_office_lib_get_PowerCt_task_source	任务积分不足	0						
world_office_lib_launch_war_horn_is_famous	不是名城	0						
world_office_lib_launch_war_horn_is_over	当前有正在发起的号角	0						
world_office_lib_launch_war_horn_jurisdiction	权限不足	0						
world_office_lib_launch_war_horn_len	口号长度超限制	0						
world_office_lib_launch_war_horn_mask	含有敏感词，请重新输入	1						
world_office_lib_launch_war_horn_prop	消耗的道具不足	0						
world_office_lib_launch_war_horn_time	冷却时间不足！	0						
world_office_lib_launch_war_horn_type	世界官职发起战争号角类型错误	0						
world_office_lib_launch_war_horn_war_horn	本势力不满足发起战争号角条件	0						
world_office_lib_leave_office_PowerCt	和被卸任的玩家不是同一个势力	0						
world_office_lib_leave_office_is_office	被卸任的玩家没有官职	0						
world_office_lib_leave_office_jurisdiction	权限不足	0						
world_office_lib_national_policy_is_over	当前有国策执行中	0						
world_office_lib_national_policy_jurisdiction	权限不足	0						
world_office_lib_national_policy_target_national_time	国策CD中	0						
world_office_lib_replace_appoint_PowerCt	势力不相同	0						
world_office_lib_replace_appoint_is_office	被卸任角色没有官职	0						
world_office_lib_replace_appoint_jurisdiction	权限不足	0						
world_office_lib_replace_appoint_open_limit	官职未解锁	0						
world_office_lib_update_office_name_jurisdiction	权限不足	0						
world_office_lib_update_office_name_len	封号内容超限制	0						
world_office_lib_update_office_name_mask	含有敏感词，请重新输入	1						
arena_not_fight_self	挑战的UID是本人，不能挑战自己	0						
fete_not_open	祭祀未开启	0						
town_lib_town_rmb_contribute_rmb	城池元宝捐献元宝不足	0						
town_lib_town_rmb_contribute_build_town_exp_max	城池元宝捐献获得的经验超过城池最大经验	0						
town_lib_town_rmb_contribute_role_times	城池元宝捐献个人剩余次数不足	0						
town_lib_town_rmb_contribute_town_times	城池元宝捐献城池剩余次数不足	0						
card_up_exp_prop_num_surpass_need_num	经验书的数量不需要那么多	0						
have_monster_house	已拥有怪物营地，不能再次使用令牌	0						
not_find_null_point	周围未找到空地，怪物营地生成失败	0						
fight_monster_house_max_num	攻打怪物营地已达最大次数	0						
monster_house_not_find	怪物营地未找到	0						
monster_house_point_destry	怪物营地被攻击的点已被占领	0						
max_receive_day_times	怪物营地令牌每日领取到达上限	0						
chapter_lib_receive_monster_house_goods_monster_house_mod	只有在怪物营地玩法阶段，才能领取剿匪令牌	0						
chapter_lib_receive_monster_house_goods_role_level	等级不足，不能领取剿匪令牌	0						
not_open_choose	预选势力未开放	0						
report_not_collect	战报未收藏	0						
report_has_collected	战报已经收藏	0						
role_corps_bagua_cd	个人冷却时间内无法参与答题！	0						
corps_bagua_index_error	八阵图方位错误	0						
corps_bagua_not_open	八阵图未开启！	0						
corps_bagua_lib_use_no_event	八阵图被召唤时无法使用阴阳爻！	0						
corps_bagua_lib_use_prop	道具不足！	0						
corps_bagua_lib_use_corps_bagua_no_event	同时只能召唤一个八阵图！	0						
corps_bagua_lib_use_corps_bagua_corps_position_limit	权限不足无法召唤八阵图！	0						
corps_bagua_lib_use_corps_bagua_corps_all_complete	八阵图能量未满无法召唤！	0						
corps_bagua_lib_use_corps_bagua_corps_event_cd_time_limit	八阵图处于冷却时间，无法召唤！	0						
corps_bagua_event_zhezhong_award_no_data	服务器处理中，请稍后再试	0						
corps_bagua_event_zhezhong_awarded	奖励已领取	0						
corps_bagua_event_zhezhong_award_no_index_data	条件不满足，无法领取奖励	0						
corps_bagua_event_no_more_than_one_gid	同时只能派遣一支队伍前往八阵图·折冲	0						
no_corps_bagua_event	没有八阵图事件！	0						
corps_bagua_event_times_limit	剩余派遣次数不足！	0						
corps_bagua_event_time_out	八阵图的能力耗尽，已从地图上消失！	0						
can_not_use	免战牌不能使用	0						
corps_resource_marching_lv_limit	军垦田行军，等级不足	0						
can_not_plunder_by_same_owner	相同拥有者，不能掠夺	0						
town_not_have_owner	军垦田所属城池无归属，不能行军	0						
can_not_collect_by_not_the_owner	军垦田不属于己方，不能采集	0						
can_not_occ_by_not_the_owner	军垦田不属于己方，不能驻防	0						
active_is_over	活动已结束	0						
no_active_open	活动未开启	0						
skill36_has_equip	该计略已经装备在队伍中	0						
storage_max_num_limit_equipment	背包装备栏位空间不足，请及时清理！	0						
storage_max_num_limit_card	卡牌包裹数量不足	2						
storage_max_num_limit_treasure	背包宝物栏位空间不足，请及时清理！	0						
storage_max_num_limit_goods	背包物品栏位空间不足，请及时清理！	0						
storage_max_num_limit_mount	背包物品栏位空间不足，请及时清理！	0						
storage_max_num_limit_mount_equipment	背包物品栏位空间不足，请及时清理！	0						
never_have_this_card	不曾拥有过这个武将	0						
everday_evaluation_times_limit	每日评论次数达到上限	0						
no_evaluation	没有评价	0						
only_time_stamp	同一条评论只能踩一次	0						
only_time_support	同一条评论只能赞一次	0						
sup_stp_times_limit	每日赞和踩的次数达到上限	0						
not_the_owner	军垦田不属于己方，不能修改军垦田信息	0						
corps_pos_limit	职位限制，不能修改军垦田信息	0						
content_size_limit	长度限制，修改失败	0						
can_not_evaluate_own	不能点赞或踩自己的评论	0						
all_evaluate_times_limit	评论达到总次数	0						
check_function_db_check_function_db_role_lv_card_comment_port_evaluate	武将评价玩家等级限制	0						
check_function_db_check_function_db_role_lv_card_comment_port_support_or_stamp	武将评价点赞或踩玩家等级限制	0						
content_length_min_six_max_sixty	武将评价最小6个字，最大60个字	0						
card_role_evaluate_num_limit	玩家单个武将评论条数限制	0						
town_fight_famous_chief_num_limit	攻打名城，郡城数量不足	0						
error_checkin_game_rmb	补签金票不足	0						
no_skill36_buff	没有计略buff	0						
no_skill36_open	计略未解锁	0						
fight_num_limit	攻打次数不足	0						
mount_equip_not_put	坐骑装备数据错误	0						
mount_storage_full	坐骑包裹已满	0						
mount_equipment_storage_full	坐骑装备包裹已满	0						
game_proposal_cd_time_limit	悬赏纳谏提交冷却中	0						
game_proposal_content_size_limit	悬赏纳谏内容长度超限	0						
check_function_db_check_function_db_role_lv_game_proposal	玩家等级达到10级后开启！	1						
garray_formation_no_study	该阵法还没学习	0						
no_garray_formation	没有该阵法	0						
check_function_db_check_function_db_then_chapter_stage_put_mount	剧本阶段限制	0						
horse_ranch_same_name	不可修改为与当前相同的化名	0						
horse_ranch_change_name_cd	修改化名处于冷却时间	0						
horse_ranch_lib_change_name_game_rmb	更改化名金券不足	0						
no_guodu_PowerCt	不能转入无王城的势力	0						
must_quit_corps	转势力必须退出联盟	0						
no_questionnaire	没有问卷	0						
no_questionnaire_info	没有问卷信息	0						
no_questionnaire_id	没有问卷id	0						
use_limit	使用背包物品限制	0						
farmer_not_dispatch_building	农夫没有派遣在这个建筑上	0						
no_farmer	没有劳工数据	0						
building_farmer_dispatch_max_num_limit	建筑物派遣的劳工个数上限	0						
farmer_dispatching	农夫正在派遣中	0						
farmer_storage_full	民居已满,请主公管理后再领取	0						
uid_exists_in_two_lists_at_the_same_time	该劳工不能同时上下派遣	0						
farmer_dispatch_bsid_limit	该农夫不能派遣在该建筑	0						
farmer_no_red_point	该农夫最近获得过新特性	0						
check_function_db_check_function_db_build_sid_lv_garrison_port_up_garray	队伍驻防的时候建筑物等级限制	0						
not_arrive	行军没有到达	0						
march_not_find	没有行军信息	0						
no_city	城池id不存在	0						
no_move_order	行动点不足	0						
no_occupied	城池未被占领	0						
select_diff_not_unlock	难度没有解锁	0						
no_occ	城池未被占领	0						
is_no_soldiers	武将未配兵	0						
new_performance_action_point_limit	行动点不足	0						
garray_not_idle	队伍还未返回城池	0						
new_performance_reset_num_limit	重置次数已达上限	0						
plunder_max_num_limit	采集其他联盟军垦田次数已达上限	0						
collect_max_num_limit	采集军垦田次数已达上限	0						
garray_error	当前队伍无法行军	0						
have_choose_camp_house	已经选择了怪物营寨	0						
camp_house_uid_error	怪物营寨id错误	0						
can_not_use_good	该物品不能使用	0						
monster_house_point_distory	该点上黄巾营地已被摧毁	0						
achieve_completed_but_can_not_get_award	不满足领奖条件	0						
achieve_completed_but_can_not_get_award_5	领取失败，您不在达成目标的联盟中	0						
achieve_completed_but_can_not_get_award_6	领取失败，您不在达成目标的势力中	0						
achieve_completed_but_can_not_get_award_7	领取失败，任务目标达成时您未在本联盟中	0						
achieve_completed_but_can_not_get_award_8	领取失败，任务目标达成时您未在当前势力中	0						
farmer_not_havent	该劳工已被遣散	0						
max_search_day_times	今日黄巾营地探寻次数已达上限	0						
no_near_by_rebel_forces	附近暂无蛮兵，请稍后再试	0						
collection_too_much	收藏邮箱已达存储上限	0						
corps_email_too_much	联盟邮箱已达存储上限	0						
system_email_too_much	系统邮箱已达存储上线	0						
mass_room_no_exist	集结房间不存在	1						
mass_room_role_max_num_limit	集结房间人数达到最大	0						
you_no_mass_room_owner	你不是集结房间房主	0						
mass_room_uids_sort_error	集结房间排序uid不全	0						
uid_no_in_mass_room	集结房间排序uid错误	0						
confirm_create_boss_time_limit	确认生成集结boss的时候，超过有效时间	0						
no_point_create_mass_boss	没有空点创建集结boss	0						
no_mass_boss	集结boss不存在	0						
leisure_num_limit	预备兵数量不足	0						
can_not_create_more_than_one_mass_room	玩家只能创建一个集结房间	0						
no_mass_room	没有这个集结房间	0						
mass_garrays_is_set_out	集结队伍已经出发，不能操作	0						
can_not_join_the_same_mass_room_again	你已经加入该房间	0						
no_join_mass_room	没有加入过该集结房间	0						
mass_room_no_kickout_self	不能自己踢出自己	0						
attack_mass_boss_need_role_num_limit	进攻集结boss需要的最小人数不够	0						
mass_room_member_no_all_occ	进攻集结boss需要的所有的成员都达到集结点	0						
corps_resource_have_ower	军垦田采集权已有归属，不能行军	0						
war_makes_lib_buy_buy_rmb	演义战令购买经验元宝不足	0						
war_makes_lib_get_award_type_lv	演义战令奖励已领取	0						
war_makes_lib_get_award_war_makes_lv	演义战令该等级奖励不能领取	0						
war_makes_lib_get_award_prime	演义战令付费奖励已领取	0						
corps_bagua_lib_use_corps_bagua_all_complete	拼装已全部完成	0						
only_can_equip_one_team	不能装备相同的计略	0						
res_protect	资源保护中	0						
res_not_exit	资源不存在	0						
no_labourer	劳工不存在	0						
map_build_not_exit	仓库不存在	0						
res_not_occupy	没有占领该资源	0						
res_not_enough	资源不足	0						
res_state_error	资源当前状态不允许进行该操作	0						
set_repeat_dest	重复派遣同一个目的地	0						
dispatch_num_limit	派遣数量超过上限	0						
rand_defeat	随机劳工特性失败	0						
unlock_features_repeat	劳工该槽位已经解锁特性	0						
index_over	劳工解锁槽位超出	0						
have_gain_labourer	有劳工在收取	0						
no_res	没有资源	0						
bind_res_num_limit	绑定资源点数量超过上限	0						
soldiers_sid_lock	兵种未解锁	0						
soldiers_has_locked	该兵种已经解锁	0						
set_soldiers_has_max	设置兵种个数达上限	0						
card_consum_num_err	兵种消耗卡片数量错误  	0						
need_off_card_treasure	解锁兵种需要先卸下宝物	0						
card_num_not_enough	解锁兵种低级卡卡片数量不足	0						
only_can_put_one_card	一件宝物只能穿戴在一张卡片	0						
new_treasure_lib_put_treasure_card_level	穿戴宝物卡片等级不满足	0						
new_treasure_lib_put_treasure_soldiers_type	穿戴宝物兵种类型不满足	0						
screen_word	输入含有敏感词	1						
express_lib_check_express_go_card_count 	派遣数量不足	0						
no_express_achieve	没有这个任务	0						
card_locked	卡牌正在陈情中	0						
count_notright	刷新次数不足	0						
level_havent_enough	陈情等级不足	0						
up_card_different_sid	武将升星素材卡不是同名卡	0						
resolve_card_put_treasure	请卸下武将身上的宝物再尝试分解	0						
card_lib_up_star_card	武将升星素材卡不足	0						
card_lib_reset_potential_rmb	您的元宝不足	0						
card_lib_reset_potential_game_rmb	您的金券不足	0						
no_potential_reset	当前没有可重置的属性点	0						
potential_not_enough	当前自由属性点不够	0						
init_card	改武将已经为初始状态	0						
card_up_star_no_card	存在未拥有的卡牌	0						
star_error	卡牌星级错误 	0						
report_have_no_content	请输入详细的举报内容	0						
express_not_refish	无可刷新陈情	1						
the_previous_exercise_room_is_no_over	演武沙盘正在清扫中，请主公稍后再试	1						
exercise_room_not_exist	演武不存在，请重新打开界面	1						
this_exercise_town_does_not_belong_to_the_player	不能放弃不属于自己的城池	0						
exercise_lib_marching_action_point	行动点不足无法行军	1						
exercise_lib_recall_occ_action_point	行动点不足无法召回驻防队伍	1						
exercise_lib_move_consume_move_token	迁城令不足无法迁城	1						
exercise_card_num_limit	演武卡牌背包空闲位置不足	1						
exercise_gid_has_been_unlocked	这个演武队伍已经解锁过	1						
exercise_gid_cannot_unlock	这个演武队伍不能解锁	1						
exercise_gid_not_exist	这个演武队伍不存在	0						
exercise_garray_not_idle	这个演武队伍不是空闲状态	1						
exercise_card_no_in_shop_list	演武要购买的卡不在商店数据中	1						
exercise_purchase_card_exist	演武要购买的卡已存在包裹中	1						
exercise_card_can_not_change	已拥有品质更高的同名武将！	1						
exercise_money_limit	军资不足	1						
exercise_card_num_limit	演武背包空闲位置不足	1						
exercise_card_no_exist	演武要替换的卡不存在	1						
exercise_shop_lv_max_limit	演武商店已经达到最高等级	1						
exercise_lib_up_shop_lv_exercise_money	军资不足	1						
exercise_purchase_bag_capacity_max_num_limit	演武背包扩容已经达到上限	1						
exercise_lib_add_cards_num_exercise_money	军资不足	1						
exercise_restore_max_limit	购买次数已达上限	1						
exercise_lib_change_restore_exercise_money	军资不足	1						
exercise_lib_manual_refresh_shop_exercise_money	军资不足	1						
exercise_town_protect	演武城池保护状态中，不能攻打	1						
check_function_db_check_function_db_role_lv_exercise	玩家等级不足，演武暂未开启	1						
exercise_can_not_attack_self_town	不能攻打自己的城池	1						
express_lib_check_express_refish_game_rmb	您当前金券不足	1						
have_applied	已经申请过	1						
map_build_not_nor	辎重营已经被摧毁	1						
not_mass_invite	该集结邀请已失效	1						
in_friend	已经是好友	1						
not_apply_self	不能申请自己	1						
friend_max	好友数量已达上限	1						
other_friend_max	对方好友数量已达上限	1						
in_blacklist	已被拉入黑名单	1						
forbide_add_friend	禁止添加好友，解封时间为%s	1						
forbide_changet	禁止修改文本信息，解封时间为%s	1						
not_request	没有申请信息	1						
not_friend	不是好友	1						
blacklist_max	黑名单上限	1						
enter_soldiers_limit	参与集结人数不符合房间要求	1						
room_state_can_not_set	当前房间状态不允许修改设置	1						
info_size_limit	申请信息长度上限	1						
other_lv_limit	开启好友功能需要该玩家个人势力达到200！	1						
in_other_blacklist	你已被对方拉入黑名单	1						
check_function_db_check_function_db_role_lv_friend	开启好友功能需要个人势力达到200！	1						
remark_size_limit	备注长度上限	1						
train_function_not_open	练兵功能未开启	1						
train_array_limit	练兵队伍数量限制	1						
map_build_lib_training_card_action_power	队伍内武将体力不足	1						
is_help_card	该武将为助阵武将	1						
action_power_not_enough	武将体力不足	1						
no_role_uid	没有角色的唯一id	0						
town_fight_near_limit	城池相邻郡限制	1						
auto_resolve_card_not_open	自动分解武将功能未开启	0						
chapter_lib_receive_monster_house_goods_exist_condition	开始时间条件不满足	0						
labourer_lib_labor_unlockSkill_money	铜币不足，无法解锁劳工新技能	0						
map_build_lib_create_map_build_for_sgz2_building_type	建筑等级不足	1						
map_build_lib_uplevel_for_sgz2_building_type	升级建筑等级不足	1						
PowerCt_error	势力错误	1						
point_move_error	无法迁城到该区域	1						
resource_num_not_enough	资源不足	1						
resource_is_max	该资源存储已达上限，不可交易获得	1						
cost_dont_enough	统御值不足	1						
material_card_not_idle	素材中有已上阵的武将	1						
ownership_error	归属权限制不能侦查	1						
protect_state	保护状态不能侦查	1						
in_cd_time	在侦查cd内不能侦查	1						
no_path	没有通路	1						
is_protect_not_give_up	免战期间不能放弃地块	1						
type_can_not_give_up	此类型地块不能放弃	1						
have_give_up	已经在放弃地块倒计时中	1						
no_land_is_give_up	没有正在放弃的地块可取消	1						
not_role_land	地块不属于自己	1						
skill_is_max_lv	等级已达最大	1						
card_no_skill	武将未拥有此技能	1						
treasure_is_init	宝物初始状态不能重置	1						
treasure_already_max	宝物等级以达到最大	1						
card_no_treasure	武将未穿带此宝物	1						
fihgt_error_same_corps	不能攻击属于自己或友方的领地	1						
fihgt_error_same_PowerCt	不能攻击属于同一势力	1						
state_error	地块状态错误	1						
not_owner	不是拥有者	1						
not_same_corps	无法驻防敌人的领地！	1						
sgz2_fight_lib_5_action_power	武将体力不足	1						
sgz2_fight_lib_5_role_lv	主公等级不足	1						
sgz2_fight_lib_5_influence	主公势力值不足	1						
sgz2_fight_lib_5_main_building_level	主公大殿等级不足	1						
sgz2_fight_lib_5_wood	主公木材不足	1						
sgz2_fight_lib_5_mineral	主公石料不足	1						
sgz2_fight_lib_5_iron	主公铁锭不足	1						
sgz2_fight_lib_5_forage	主公粮食不足	1						
sgz2_fight_lib_5_building_type	建筑等级限制	1						
map_build_lib_create_map_build_for_sgz2_influence	主公势力值不足	1						
PowerCt_role_num_max	该势力人数已满	1						
PowerCt_no_born_point	势力没有空余出生点	0						
fete_cd	祭祀在cd中	1						
fete_not_cd	祭祀不在cd中	1						
pvb_max	政令已经上限	1						
sgz2_fight_lib_check_action_power	武将体力不足	1						
sgz2_fight_lib_check_building_type	建筑等级不足	1						
sgz2_fight_lib_check_forage	粮食不足	1						
sgz2_fight_lib_check_influence	势力值不足	1						
sgz2_fight_lib_check_iron	铁锭不足	1						
sgz2_fight_lib_check_mineral	石料不足	1						
sgz2_fight_lib_check_wood	木材不足	1						
sgz2_fight_lib_check_main_building_level	大殿等级不足	1						
sgz2_fight_lib_check_pvb	政令不足	1						
sgz2_fight_lib_check_role_lv	玩家等级不足	1						
map_build_lib_uplevel_for_sgz2_pvb	政令不足	1						
map_build_lib_uplevel_for_sgz2_game_rmb	金券不足	1						
map_build_lib_rmb_for_uplevel_cd_game_rmb	金券不足	1						
have_no_build	没有该营寨	1						
build_garray_num_limit	营寨待命队伍已经达到上限	1						
protect_time_limit	土地保护状态中	1						
castle_lib_move_castle_cd	迁城cd中	1						
train_card_lib_training_card_pvb	政令不足	1						
resource_collect_influence	势力值达到%s才可屯田							
train_card_influence	势力值达到%s才可练兵							
map_build_influence	势力值达到%s才可建造							
role_state_lib_martial_law_open_condition_and	戒严功能未开启	1						
role_state_lib_martial_law_open_condition_or	戒严功能未开启	1						
is_rookie_protecting	新手保护状态中，无法戒严	1						
martial_state_limit	戒严状态错误	1						
garray_not_idle_for_move_castle	有部队尚未回城，不可迁城	1						
garray_not_marching	部队不在行军中	1						
no_corps_tag	标记不存在，无法删除	1						
you_shouldnt_build_in_give_up_land	放弃中的领地不可建造	1						
no_open	该功能没有开启	0						
should_destory_map_build_and_then_destory_land	建筑施工中，暂时无法放弃！	0						
not_open_express	陈情势力值不足							
not_invitition_count	当前结盟数量已达到上限	1						
not_invition	找不到这个申请							
invitition_type_error 	申请状态错误							
not_invitition	当前申请不存在							
not_find_corps_name	未查到该联盟	1						
garray_go_backed	部队已到达	1						
garray_not_in_castle	部队不在城中	1						
card_in_the_garray	武将下阵后可进行卸甲操作	1						
fihgt_error_firends_corps	不能攻击你的盟友	1						
friend_full	结盟队列已满，请解除其他申请	1						
garray_is_in_barracks	队伍已经在营寨中	1						
card_put_treasure	武将佩戴宝物，无法升星	1						
is_cowardice	队伍中有武将处于负伤状态，暂时无法出征	1						
fihgt_error_land_in_my_self	不能攻击属于自己的领地	1						
fihgt_error_no_monster	不能攻击自己没有匪寇的土地	1						
other_friend_full	结盟的联盟结盟数量已满	1						
other_corps_limit	申请的联盟结盟数量已满	1						
point_fighting_can_not_sweeping_marching	该目标点处于交战中，暂不能进行扫荡	1						
report_timeout	战报已过期	1						
is_rout_state	击溃状态不能戒严	1						
corps_bagua_lib_use_yin_yang_tool	阴阳爻不足	1						
ld_draw_game_rmb	金券不足	1						
not_give_up_self_town	不能放弃自己的城池	1						
map_build_lib_create_map_build_for_sgz2_pvb	建筑创建政令不足	1						
is_you_friend_corps	对方已经是你的盟友	1						
card_in_express	武将在陈情中不能消耗	1						
sgz2_fight_lib_resource_collect_pvb	政令不足	1						
building_is_recruiting	营寨招兵中，暂不可进行拆除操作	1						
please_destroy_build	请先拆除建筑再进行操作	1						
card_lib_up_card_skill_stratagem	韬略值不足，不能升级	1						
build_is_building	建筑还未建造完成	1						
ground_is_giving_up	3*3地基用地不可处于放弃中状态！	1						
missing_role_no_point	主公长时间未上线，我们已将您的主城暂时收起保护，但由于现在没有合适的出生位置，请主公稍后再试！	2						
pvb_day_max	政令购买次数已达上限	0						
point_fight	战斗中	1						
main_building_level_3	大殿等级不足	1						
sgz2_fight_lib_resource_collect_action_power	武将屯田体力不足	1						
train_card_lib_training_card_action_power	武将练兵体力不足	1						
train_card_lib_training_card_open_building_type	建筑等级不足	1						
train_card_lib_training_card_open_influence	开启练兵功能势力不足	1						
restore_lib_buy_pvb_game_rmb	金券不足	1						
no_queue_info	没有征兵队列信息	1						
had_unlock	宝物解锁失败	1						
new_treasure_lib_up_streng_stratagem	强化宝物韬略值不足	1						
new_treasure_lib_up_streng_need_money	强化宝物货币不足	1						
report_lib_spy_money	侦察消耗铜币不足	1						
no_mail_user	未找到该玩家，请重新输入	1						
card_is_on_other_garray	卡牌在其他队伍中	1						
exist_personal_monster_can_not_sweeping_marching	该点不能进行荡寇行军	1						
not_owner_land	该点不属于自己	1						
queue_early	招兵提前结束	1						
ld_lib_draw_half_price_times	半价抽卡次数不足	1						
ld_lib_draw_game_rmb	抽卡金券不足	1						
ordnance_no_reuse	器械上阵错误	1						
error_checkin_over	已经签到过了	1						
buy_count_overflow_today	进修购买次数不足	1						
card_practiceing	武将正在进修	1						
count_overflow_today	进修次数不足	1						
practice_lib_check_buy_rmb_count_game_rmb	进修购买次数金券不足	1						
practice_lib_check_start_practice_money	开始进修铜币不足	1						
practice_lib_check_start_practice_game_rmb	开始进修金券不足	1						
practice_lib_check_start_practice_action_power	开始进修体力不足	1						
card_in_practice	武将正在进修	1						
no_born	该势力已满员	1						
castle_lib_sgz2_create_sub_castle_max_sub_num	分城数量达到上限	0						
castle_lib_sgz2_create_sub_castle_influence	修建分城玩家势力值不足	0						
castle_lib_sgz2_create_sub_castle_pvb	修建分城玩家政令不足	0						
castle_lib_sgz2_create_sub_castle_main_building_level	修建分城主城大殿等级不足	0						
castle_lib_sgz2_create_sub_castle_wood	修建分城主城大殿木材不足	0						
castle_lib_sgz2_create_sub_castle_mineral	修建分城主城大殿石料不足	0						
castle_lib_sgz2_create_sub_castle_iron	修建分城主城大殿铁锭不足	0						
castle_lib_sgz2_create_sub_castle_forage	修建分城主城大殿粮草不足	0						
not_open_practice	进修开启条件不足	1						
influence_limit_1	世界频道开启条件不足	1						
influence_limit_2	书信开启条件不足	1						
influence_limit_3	联盟频道开启条件不足	1						
influence_limit_4	势力频道开启条件不足	1						
influence_limit_5	收费频道开启条件不足	1						
influence_limit_6	跨服频道开启条件不足	1						
influence_limit_7	军团频道开启条件不足	1						
card_had_other_consume 	武将包含多张高品质卡，请先重置武将	1						
must_owner_or_vice_owner_get_friend_recommends	权限不足	1						
is_you_enemy_corps	无法和敌对关系的联盟进行结盟	1						
tag_flower_limit	联盟标记数量已达上限	1						
not_group	该军团已被解散	1						
device_disable	该设备已被封停	1						
influence_limit_17	势力频道开启条件不足	1						
card_time_limit	月卡有效期大于60天无法再次购买	1						
fihgt_error_sgz2_mountain_fastness_no_exist	山寨已经消失不能出征	1						
influence_error_return	势力值不足	1						
castle_uid_error	该城池不存在	1						
corps_request_only_country	不在该联盟的势力覆盖范围内！	1						
map_build_lib_create_map_build_for_sgz2_ground_lv	地块等级或类型错误	1						
exchange_not_open	交易所未开放	1						
re_born_cd	再起冷却中 	1						
is_recruit	正在招兵中 	1						
change_error	兑换失败 	1						
montha_get_fail	月卡奖励领取失败 	1						
check_function_db_check_function_db_role_infulence_friend 	添加好友势力值不足	1						
card_in_lock	卡牌已经上锁	1						
building_lib_building_up_game_rmb	升级建筑金饼不足	1						
col_resource_limit	屯田资源超出上限	1						
corps_commander_num_limit	指挥官任命数量上限	1						
corps_diplomat_num_limit	外交官任命数量上限	1						
no_fete	免费次数未用完	1						
chat_uid_error	聊天uid错误	1						
garray_not_in_build	队伍不在可招兵建筑中	1						
expired	卡包已过期	1						
ld_disappear	未找到卡包	1						
card_lib_second_slot_card_lv	解锁第二宝物消耗卡牌等级不足	1						
comm_cd_limit	操作过于频繁	0						
bridge_can_not_build	桥梁不能修建	1						
not_find_castle	没有找到该城池	1						
main_castle_can_not_destroy	主城不能拆除	1						
castle_state_error	城池状态有误，不能拆除	1						
shop_db_checks_game_rmb	商店购买金饼不足	1						
corps_judge_num_limit	执法官任命数量上限	1						
card_level_overflow	卡牌等级超过最大上限	1						
has_lock	解锁武将阵型已上锁	1						
group_mem_max	此军团已满	1						
already_recruit	武将正在征兵	1						
sub_castle_can_not_move	分城不能迁城	1						
content_error	发送的内容错误	1						
gm_empty	没有有效gm指令	1						
cant_gm	禁止使用聊天gm	1						
need_queue	需要排队	1						
lose_vision	已失去视野	1						
garray_leave	队伍已离开	1						
log_unknow_err	登录错误	1						
not_idc_environment	不是idc环境	1						
cfg_error	L5配置错误	1						
times_limit	次数不足	1						
cd_limit	CD中	1						
web_err	网络错误	1						
share_error	分享失败	1						
ask_error	索要下单失败	1						
channel_error	登录渠道错误	1						
corps_err	无军团或职位错误	1						
card_storage_full	武将背包已满，请先清理武将背包。	1						
ocard_not_consume	操作武将不可作为消耗武将	1						
limitg_is_giving	限购物品正在发货中	1						
condition_limit	条件不满足	1						
ld_lib_draw_limit_free_times 	免费次数不足 	1						
corps_lib_corps_resources_donate_forage	资源不足	1						
need_same_quality_card	需要相同品质的武将	1						
developmenting	该点有拓路部队，不能放弃土地	1						
development_is_one	拓路部队只允许存在一支	1						
sgz2_fight_lib_development_route_action_power	拓路体力不足	1						
corps_lib_unlock_study_corps_iron 	联盟铁矿不足 	1						
corps_lib_unlock_study_corps_wood	联盟木材不足	1						
corps_lib_unlock_study_corps_forage	联盟粮草不足	1						
corps_lib_unlock_study_corps_mineral	联盟石头不足	1						
corps_study_lock	所需科技未解锁	1						
land_type_limit	地块类型限制	1						
land_lv_limit	地块等级限制	1						
build_num_max	建筑当前数量已达上限	1						
build_lv_max	建筑当前等级已达上限	1						
corps_build_not_destroy	没有正在拆除的建筑	1						
give_up_land_cant_collect	土地放弃中，不可屯田	1						
give_up_land_cant_train	土地放弃中，不可练兵	1						
need_owner_nine_self_diji	只能迁城到九块属于自己的地基中央	1						
corps_wood_not_enough	联盟木材不足	1						
corps_iron_not_enough	联盟铁矿不足	1						
corps_mineral_not_enough	联盟石头不足	1						
corps_forage_not_enough	联盟粮草不足	1						
corps_money_not_enough	联盟铜币不足	1						
cant_cross_chat	不能跨服聊天	1						
g_array_error	分享队伍为空	1						
audio_err	语音信息存在屏蔽字	1						
land_is_change	地块发生改变，不能练兵	1						
developmenting_stop_train	该点有拓路部队，不能进行练兵	1						
developmenting_stop_col	该点有拓路部队，不能进行屯田	1						
script_is_over	剧本已结束	0						
developmenting_creat_map	该点有拓路部队，不能进行建造	1						
card_lib_up_star_color_card	闪卡素材卡不足	1						
horn_lib_send_horn_role_infulence	势力值不足	1						
this_corps_in_country	联盟已经加入了某个国家	1						
no_country	没有国家	1						
no_owner_country	不是国家拥有者	1						
sub_corps_num_limit	附属联盟上限	1						
max_corps_country_num_limit	全服国家数量上限	1						
country_creating	国家创建中	1						
no_owner_town	没有占领这个城池	1						
country_exist	这个国家已存在	1						
same_guodu	相同的国都	1						
no_invite	没有邀请	1						
country_corps_relation_11_11	邀请同一个联盟成为附属盟冷却时间	1						
corps_no_exist	联盟不存在	1						
country_flag_used	国家旗帜被使用	1						
words_filter_error	功能不可用	1						
use_help_overflow	使用协战次数已达上限	1						
select_dif	难度出现异常	1						
duplicate_dif_pass	难度已经通关	1						
no_bandit	流寇已经消失，不能攻打流寇	1						
script_can_not_create	无法在除新手服之外的服务器创建角色！	0						
role_is_transfer	角色已转移	0						
sgz2_duplicate_lib_check_open_role_max_influence	论兵未开启	1						
no_corps_by_duplicate	您已退出联盟，请加入联盟后再试	1						
duplicate_num_limit	论兵挑战次数不足	1						
script_limit	当前剧本限制报名	1						
script_state_error	服务器剧本状态错误	1						
already_enroll	已经报名剧本	1						
in_cd	报名cd中	1						
enroll_num_limit	剧本报名人数限制	1						
in_team	已经在队伍中	1						
no_power	权限不足	1						
type_error	报名类型错误	1						
no_enroll	还没有报名剧本	1						
is_locked	状态锁定中	1						
enroll_team_lib_create_game_rmb	金饼不足	1						
in_script_team	在小队中	1						
apply_num_limit	申请条数限制	1						
already_apply	已经申请过	1						
team_is_locked	小队已锁定	1						
member_limit	成员人数上限	1						
team_owner	小队长不能被踢	1						
not_in_team	不在小队内	1						
not_confirm	还未确认	1						
not_same_team	不是同一小队	1						
group_num_limit	小组人数限制	1						
not_in_group	不在小组中	1						
no_team	没有小队	1						
not_in_group	不在小组中	1						
search_none	没有搜索到对应信息	1						
script_lib_sign_up_influence	报名势力值不足	1						
